이계안	withkal 
정갑윤	kyjung2206 
원유철	won6767 
이춘석	lcs1747
김무성	kimmoosung
나경원	nakw
원희룡	Wonheeryong
남경필	yesKP
홍준표	joonpyohong
김문수	kimmoonsoo1
진수희	sheechin
정병국	withbg 
정두언	doorun
이지안	leegian 
이상곤	sangkonkim 
문성근	actormoon 
안희정	steelroot 
송영길	Bulloger
강용석	Kang_yongseok 
추미애	choomiae
김관진	kwanjinkim
문재인	moonriver365
권영길	KwonYoungGhil
이광재	yeslkj
천호선	hosun1000 
고승덕	dreamfarmers 
정봉주	BBK_Sniper 
한명숙	HanMyeongSook
박영선	HanMyeongSook
강기갑	kanggigap
김두관	dookwan
정동영	coreacdy
손학규	HQ_Sohn 
곽노현	nohyunkwak
심상정	sangjungsim
유시민	u_simin 
이준석	junseokandylee
현경대	woori_jejudo
이정현	lee_junghyun
한선교 	hansunkyo
이계진	leekejin2018
이재오	JaeOhYi
정진석	js0904 
진영	ChinYoung
박근혜	GH_PARK
허태열	huhtaeyeol
이성현	21sh
서병수	sbs8680
이정희	heenews 
노회찬	hcroh
조윤선	yoonsunforyou
신은경 	eunkyungshine
정세균	sk0926
정몽준 	ourmj
최재천	your_rights
신지호	dobong_jiho
인재근	JGT_FOREVER
손수조	sonsujo
하태경	taekyungh
이한구	smart219
김부겸	hopekbk
우상호	uzzazza 
이인영	lee_inyoung
김창호	changhorg
전병헌	bhjun
임종석	jsstorynet
전혜숙	winner1219
정청래	ssaribi
민병두	bdmin1958
이석현	lsh4u
오영식	okys04
이미경	lmk2014
이목희	2mokhee
차영	cha_young
김영주	yjkim550727
김성동	OKSD_KIM
김유정	KimYoojung
